FNG = "countries/FNG.txt"
SRI = "countries/SRI.txt"
BOS = "countries/Bosnia.txt"
MTN = "countries/MTN.txt"
DMK = "countries/DMK.txt"
GAL = "countries/GAL.txt"
WHR = "countries/WHR.txt"
BAT = "countries/BAT.txt"
BOM = "countries/Bohemia.txt"
UKR = "countries/UKR.txt"
DKB = "countries/DKB.txt"
AZB = "countries/AZB.txt"
GEO = "countries/GEO.txt"
ARM = "countries/ARM.txt"
ALO = "countries/ALO.txt"
AOG = "countries/AOG.txt"
TRM = "countries/TRM.txt"
LEC = "countries/LEC.txt"
LYB = "countries/LYB.txt"
QIE = "countries/QIE.txt"
NFA = "countries/NFA.txt"
MAF = "countries/MAF.txt"
CAF = "countries/CAF.txt"
BHC = "countries/BHC.txt"
DEH = "countries/DEH.txt"
MAD = "countries/MAD.txt"
PRF = "countries/PRF.txt"
TRK = "countries/TRK.txt"
BUR = "countries/BUR.txt"
CAR = "countries/Carlist Spain.txt"
CNT = "countries/CNT.txt"
CSA = "countries/CSA.txt"
TEX = "countries/TEX.txt"
CAL = "countries/CAL.txt"
NEE = "countries/NEE.txt"
HAW = "countries/HAW.txt"